PSX	KEYWORD2
motor	KEYWORD2
motorEnable	KEYWORD2
mode	KEYWORD2
updateState	KEYWORD2

PSX_PAD1	LITERAL1
PSX_PAD2	LITERAL1

MOTOR1_ENABLE	LITERAL1
MOTOR1_DISABLE	LITERAL1
MOTOR2_ENABLE	LITERAL1
MOTOR2_DISABLE	LITERAL1
MOTOR1_ON	LITERAL1
MOTOR1_OFF	LITERAL1

MODE_DIGITAL	LITERAL1
MODE_ANALOG	LITERAL1

MODE_UNLOCK	LITERAL1
MODE_LOCK	LITERAL1

IS_DOWN_LEFT	KEYWORD2
IS_DOWN_DOWN	KEYWORD2
IS_DOWN_RIGHT	KEYWORD2
IS_DOWN_UP	KEYWORD2
IS_DOWN_START	KEYWORD2
IS_DOWN_STICK_RIGHT	KEYWORD2
IS_DOWN_STICK_LEFT	KEYWORD2
IS_DOWN_SELECT	KEYWORD2

IS_DOWN_SQUARE	KEYWORD2
IS_DOWN_CROSS	KEYWORD2
IS_DOWN_CIRCLE	KEYWORD2
IS_DOWN_TRIANGLE	KEYWORD2
IS_DOWN_R1	KEYWORD2
IS_DOWN_L1	KEYWORD2
IS_DOWN_R2	KEYWORD2
IS_DOWN_L2	KEYWORD2

PRESSED_LEFT	KEYWORD2
PRESSED_DOWN	KEYWORD2
PRESSED_RIGHT	KEYWORD2
PRESSED_UP	KEYWORD2
PRESSED_START	KEYWORD2
PRESSED_STICK_RIGHT	KEYWORD2
PRESSED_STICK_LEFT	KEYWORD2
PRESSED_SELECT	KEYWORD2

PRESSED_SQUARE	KEYWORD2
PRESSED_CROSS	KEYWORD2
PRESSED_CIRCLE	KEYWORD2
PRESSED_TRIANGLE	KEYWORD2
PRESSED_R1	KEYWORD2
PRESSED_L1	KEYWORD2
PRESSED_R2	KEYWORD2
PRESSED_L2	KEYWORD2

RELEASED_LEFT	KEYWORD2
RELEASED_DOWN	KEYWORD2
RELEASED_RIGHT	KEYWORD2
RELEASED_UP	KEYWORD2
RELEASED_START	KEYWORD2
RELEASED_STICK_RIGHT	KEYWORD2
RELEASED_STICK_LEFT	KEYWORD2
RELEASED_SELECT	KEYWORD2

RELEASED_SQUARE	KEYWORD2
RELEASED_CROSS	KEYWORD2
RELEASED_CIRCLE	KEYWORD2
RELEASED_TRIANGLE	KEYWORD2
RELEASED_R1	KEYWORD2
RELEASED_L1	KEYWORD2
RELEASED_R2	KEYWORD2
RELEASED_L2	KEYWORD2

ANALOG_RIGHT_X	KEYWORD2
ANALOG_RIGHT_Y	KEYWORD2
ANALOG_LEFT_X	KEYWORD2
ANALOG_LEFT_Y	KEYWORD2
